+++++++++++++++++
+d      ---     +
+ -------   -   +
+       -----   +
+       -       +
+     --------  +
+               +
+   ------------+
+  -----   --   +
+      ----     +
+         ----  +
+     ---       +
+ --------------+
+  -        ----+
+  -    -       +
+       -      a+
++++++++++++++++