+++++++++++++++++
+s      ---     +
+ -------   -   +
+       -----   +
+       -       +
+     --------  +
+               +
+   ------------+
+  -----    -   +
+      ----     +
+         ----  +
+     ---       +
+ --------------+
+  -        ----+
+  -    -       +
+       -      e+
+++++++++++++++++