+++++++++++++++++
+s        -     +
+ -------   ----+
+       -----   +
+-----          +
+      ---------+
+- ---          +
+    - ---------+
+ ---- -    -   +
+ -  - ----     +
+ - --    ----  +
+ -  -  -       +
+ -- -  --------+
+  -    -       +
+---- -    ---- +
+     ----    -e+
+++++++++++++++++